xx1x2x3xxx
x        x
x        x
e        a
x        x
x        x
xxxx$xxxxx
